BATTLEFIELD

Golden Forest - 1080 Snowboarding
Blue Flame - 1080 Snowboarding
Sprinter - Super Hang-On


DREAM LAND

The Offing - SEGA Marine Fishing
Snow Sisters - Under Night InBirth
Snowland - Street Fighter III 3rd strike 

FINAL DESTINATION

Fire's Last Hope - Rivals Of Aether
Road Mauler - Ridge Racer 6
You're Mine - Furi

FRIGATE HUSK

Beats From Above - Klonoa Door To Phantomile
Monster Karasu - Soul of the Samurai
Psyche Out - Street Fighter III 3rd Strike

LUIGI'S MANSION

Mission Battle - FateUnlimited Codes
Emiya - FateUnlimited Codes 
Colliding Spirits - FateUnlimited Codes 


MENU
Ape Escape - Stadium Attack
White Out - 1080 Snowboarding
Spunky - Street Fighter III 3rd Strike
db - 1080 snowboarding
Don't Preheat Your Oven - Pizza Tower


POKEMON STADIUM 2

Main theme - Zanac X Zanac 
Karma Electric Fountain - Tekken 6
Heavenly Sky - Sonic Frontiers


RESULTS
Snowfield Story - Zanac X Zanac
Lost - 1080 Snowboarding
Lucid Rhythms - Ridge Racer Type 4
RidgeCityFM - Ridge Racer V


SMASHVILLE

Spiral Ahead - Ridge Racer Type 4 
Move Me - Ridge Racer Type 4 
Highway Fusion - Ridge Racer 6 
Redial - Bomberman Hero


TEMPLE OF TIME

Baladium's Drive - Kolonoa Door To Phantomville 
Theme of Phoenix - Marvel vs Capcom 3
Beat the Angel - Tales of Symphonia


YOSHI'S ISLAND

Burnin Rubber - Ridge Racer Type 4
You Blow My Mind - Street Fighter III 3rd Strike
Rhythmical Bustle - Melty Blood Actress Again

